1000111111111111
1000000000000001
1000000000000001
1000000000000001
1000000000000001
1000000000000001
1000000220000001
1000022222200001
1000022222200001
1000022222200001
1000022222200001
1111111111111111